111111111111111111111111111
100000000000000000000000001
101000000010000100001000101
101000000010001010001000101
100100000100001010000101001
100100100100011111000010001
100010101000010001000010001
100001010000010001000010001
100000000000000000000000001
100000000000000000000000001
100000000000000000000000001
100000000000000000000000001
100000000000000000000000001
100000000000000000000000001
100000000000000000000000001
100000000000000000000000001
100000000000000000000000001
100000000000000000000000001
100000000000000000000000001
100000000000000000000000001
100000000000000000000000001
100000000000000000000000001
10000000000000000000000PEC1
111111111111111111111111111
